001001001001001001001001001001001001001001001001001001001001001001001001001001001001001001001001001001001001001001001001001001001001001001001001001001001001001001001001001001001001001001001001001001001001001001001001001001001001001001001001001001001001001001001001001001001001001002002002002002002002
001001001001001001001001001001001001001001001001001001001001001001001001001001001001001001001001001001001001001001001001001001001001001001001001001001001001001001001001001001001001001001001001002001001001001001001001001001001001001001001001001001001001001001001001001001001001001002001001001001001002
001001001001001001001001001001001001001001001001001001001001001001001001001001001001001001001001001001001001001001001001001001001001001001001001001001001001001001001001001001001001001001001001002001001001001001001001001001001001001001001001001001001001001001001001001001001001001002001001001001001002
001001001001001001001001002002002002002002002002002001001001001001001001001001001001001001001001001001001001001001001001001001001001001001001001001001001001001001001001001001001001001001001001002002002002001001001001001001001001001001001001001001001001001001001001001001001001001002001001002002002002
001001001001001001001001002001001001001001001001002001001001002001001001001001001001001001001001001001001001001001001001001001001001001001001001001001001001001001001001001001001001001001001001001001001002001001001001001001001001001001001001001001001001001001001001001001001001001002001001002001001001
001001001001001001001001002001001001001001001001002001001001001002001001001001001001001001001001001001001001001001001001001001001001001001001001001001001001001001001001001001001001001001001001001001001002001001001001001001001001001001001001001001001001001001001001001001001001001002001001002001001001
001001001001001001001001002001001001001001001001002001002002002002002001001001001001001001001001001001001001001001001001001001001001001001001001001001001001001001001001001001001001001001001001001001001002001001001001001001001001001001001001001001001001001001001001001001001001001002001001002001001001
001001001001001001001001002001001001001001001001002001001001001002001001001001001001001001001001001001001001001001001001001001001001001001001001001001001001001001001001001001001001001001001001001001001002001001001001001001001001001001001001001001001001001001001001001001001001001002001001002001001001
001001001001001001001001002001001001001001001001002001001001002001001001001001001001001001001001001001001001001001001001001001001001001001001001001001001001001001001001001001001001001001001001001001001002001001001001001001001001001001001001001001001001001001001001001001001001001002001001002001001001
001001001001001001001001002001001001001001001001002001001001001001001001001001001001001001001001001001001001001001001001001001001001001001001001001001001001001001001001001001001001001001001001001001001002001001001001001001001001001001001001001001001001001001001001001001001001001001001001002001001001
001001001001001001001001001001001001002001001001002002002002002002002002002001001001001001001001001001001001001001001001001001001001001001001001001001001001001001001001001001001001001001001001001001001002001001001001001001001001001001001001001001001001001001001001001001001001001001001001002001001001
003001001001001001001001001001001001002001001001002001001001001001001001001001001001001001001001001001001001001001001001001001001001001001001001001001001001001001001001001001001001001001001001001001001002001001001001001001001001001001001001001001001001001001001001001002002002002002001001002001001001
001001001001001001001001001001001001002001001001002001001001001001001001001001001001001001001001001001001001001001001001001001001001001001001001001001001001001001001001001001001001001001001001001001001002001001001001001001001001001002001001001001001001001001001001001002001001001002001001002001001001
002002002001001002002002002002002002002002002001002001001001001001001001001001001001001001001001001001001001001001001001001001001001001001001001001001001001001001001001001001001001001001001001001001001002001001001001001001001001001002001001001001001001001001001001001002001001001002001001002001001001
001001002001001002001001001001001001002001001001002001001001002002002002002002002002002002002002002002002001001001001001001001001001001001002002002002001001001001001001001001001002002002002002002001001002001001001001001001001001001002001001001001001001001001001001001002001001001002001001002001001001
001001002007007002001001001001001001002001001001002001001001002001001001001001001001001001001001001001001001001001001001001001001001001001001001001001001001001001001001001001001001001001001001002001001002001001001001001001002002001002002002001001002002002001001002002002001001001002001001002001001001
001001002002002002001001001001001001002001001001002001001004002001001001001001001001001001001001001001001001001001001001001001001001001001001001001001001001001001001001001001001001001001001001002001001002001001001001001001001001001001001001001001001001002001001001001001001001001002001001002001001001
001001001001001001001001001001001001002001002002002001001001002001001001001001001001001001001001001001001001001001001001001001001001001001001001001001001001001001001001001001001001001001001001002001001002001001001001001001001001001001001001001001001001002001001001001001001001001002001001002001001001
001001001001001001001001001001001001002001001001002001001001002001001001001001001001001001001001001001001001001001001001001001001001001001001001001001001001001001001001001001001001001001001001002001001002001001001001001001001001001001001001001001001001002001001001001001001001001002001001002001001001
001001001001001001001001001001001001002001001001002001001001002001001001001001001001001001001001001001001001001001001001001001001001001001001001001001001001001001001001001001001001001001001001002001001002001001001001001001001001001001001001001001001001001001001001001001001001001002002002002001001001
001001001001001001001001001001001001002001001001002001001001002001001001001001001001001001001001001001001001001001001001001001001001001001001001001001001001001001001001001001001001001001001001002001001002002002002001001001001001001001001001001001001001001001001001001001001001001001001001001001001001
001001001001001001001001001001001001002002001001002004001001002001001001001001001001001001001001001001001001001001001001001001001001001001001001001001001001001001001001001001001001001001001001002001001002001001001001001001001001001001001001001001001001001001001001001001001001001001001001001001001001
001001001001001001001001001001001001002001001001002001001001002001001001001001001001001001001001001001001001001001001001001001001001001001001001001001001001001001001001001001001001001001001001002001001002001001001001001001001001001001001001001001001001001001001001001001001001001001001001001001001001
001001001001001001001001001001001001002001001001002001001001002001001001001001001001001001001001001001001001001001001001001001001001001001001001001001001001001001001001001001001001001001001001002001001001001001001001001001001001001001001001001001001001001001001001001001001001001001001001001001001001
001001001001001001001001001001001001002001001001002001001001002001001001001001001001001001001001001001001001001001001001001001001001001001001001001001001001001001001001001001001001001001001001002001001001001001001001001001001002001001001001001001001001001001001001001001001001001001001001001001001001
001001001001001001001001001001001001002001001007002001001001002001001001001001001001001001001001001001001001001001001001001001001001001001001001001001001001001001001001001001001001001001001001002001001001001001001001001002002002001001001001001001001001001001001001001001001001001001001001001001001001
001001001001001001001001001001001001002001001002002001001001002001001001001001001001001001001001001001001001001001001001001001001001001001001001001001001001001001001001001001001001001001001001002002002002001001001001001001001001001001001001001001001001001001001001001001001001001001001001001001001001
001001001001001001001001001001001001002001001001001001001004002001001001001001001001001001001001001001001001001001001001001001001001001001001001001001001001001001001001001001001001001001001001001001001001001001001001001001001001001001001001001001001001001001001001001001001001001001001001001001001001
001001001001001001001001001001001001002002002002002002002002002001001001001001001001001001001001001001001001001001001001001001001001001001001001001001001001001001001001001001001001001001001001001001001001001001001001001001001001001001001001001001001001001001001001001001001001001002002002002001001001
